XXXXXXXXXXXXXXXXXXXXXXXXXXXXXXXXXXXXXXXXXXXXXXXXXXXXXXXXXXXXXXXXXXXXXXXXXXXXXXXXXXXXXXXXXXXXXXXXXXXXXXXXXXXXXXXXXXXXXXXXXXXXXXXXXXXXXXXXXXXXXXXXXXXXXXXXXXXXXXXXXXXXXXXXXXXXXXXXXXXXXXXXXXXXXXXXXXXXXXXXXXXXXXXXXXXXXXXXXXXXXXXXXXXXXXXXXXXXXXXX
                                                                                                                  Z                                                                                               Z                             
                                                CCCCCCC                Z                                          Z                                                                                              Z                CCC    CCC    
                                                CCCCCC                 Z                                          Z                                                C                                            Z                CCCCC  CCCCC   
                                                CC                     Z                             Z     C      Z                                               C C                        CCCCC                              CCCCCCCCCCCCCC  
                                                                       Z                            Z Z     C     Z              ZZZZZZZZZZZZZZZZZZZZ            C   C                          CCC       ZZZZZZZ               CCCCCCCCCCCC    
                                                                       Z                           Z   Z     C                                                  C     C                       Z   CC                              CCCCCCCCCC    
                                    CC                 Z                      CCCCCCCCCCC         Z     Z     C                  CCCCCCCCCCCCCCCCCCCC          C   Z   C       CCCCC           Z    C     CCCCCC                   CCCCCCCC     
                                  CCCCCC               Z                                         Z       Z     C                                              C   Z Z   C      CCCCC            Z          CCCC                     CCCCCC      
                                CCCCCCCCCC             Z                      ZZZZZZZZZZZ       Z         Z     C                ZZZZZZZZZZZZZZZZZZZZ        C   Z   Z   C     CCCCC             Z          CC                       CCCC       
                                                                                               Z           Z     CCCCCC                                     C   Z     Z   C                                          Z                CC        
XXXXXXXXXXXXXXXXXXXXXXXXXXXXXXXXXXXXXXXXXXXXXXXXXXXXXXXXXXXXXXXXXXXXXXXXXXXXXXXXXXXXXXXXXXXXXXXXXXXXXXXXXXXXXXXXXXXXXXXXXXXXXXXXXXXXXXXXXXXXXXXXXXXXXXXXXXXXXXXXXXXXXXXXXXXXXXXXXXXXXXXXXXXXXXXXXXXXXXXXXXXXXXXXXXXXXXXXXXXXXXXXXXXXXXXXXXXXXXXX