ZZZZZZZZZZZZZZZZZZZZZZZZZZZZZZZZZZZZZZZZZZZZZZZZZZZZZZZZZZZZZZZZZZZZZZZZZZZZZZZZZZZZZZZZZZZZZZZZZZZZZZZZZZZZZZZZZZZZZZZZZZZZZZZZZZZZZZZZZZZZZZZZZZZZZZZZZZZZZZZZZZZZZZZZZZZZZZZZZZZZZZZZZZZZZZZZZZZZZZZZZZZZZZZZZZZZZZZZZZZZZZZZZZZZZZZZZZZZZZZZ
                                                                                                                  Z                                                                                                                             
                                                CCCCCCC                                                           Z                                                                                                               CCC    CCC    
                                                CCCCCC                 Z                                          Z                                                C                                           Z                 CCCCC  CCCCC   
                                                CC                     Z                             Z     C      Z                                               C C                        CCCCC            Z                 CCCCCCCCCCCCCC  
                                                                       Z                            Z Z     C     Z              ZZZZZZZZZZZZZZZZZZZZ            C   C                          CCC       ZZZZZZ                CCCCCCCCCCCCCC  
                                                                       Z                           Z   Z     C                                                  C     C                       Z   CC                             CCCCCCCCCCCC   
                                    CC                 Z                      CCCCCCCCCCC         Z     Z     C                  CCCCCCCCCCCCCCCCCCCC          C   Z   C       CCCCC           Z    C     CCCCCC                  CCCCCCCCCC    
                                  CCCCCC               Z                                         Z       Z     C                                              C   Z Z   C      CCCCC            Z          CCCC      Z              CCCCCC      
                                CCCCCCCCCC             Z                      ZZZZZZZZZZZ       Z         Z     C                ZZZZZZZZZZZZZZZZZZZZ        C   Z   Z   C     CCCCC             Z          CC       Z               CCCC       
                                                       Z                                       Z           Z     CCCCCC                                     C   Z     Z   C                                          Z                CC        
ZZZZZZZZZZZZZZZZZZZZZZZZZZZZZZZZZZZZZZZZZZZZZZZZZZZZZZZZZZZZZZZZZZZZZZZZZZZZZZZZZZZZZZZZZZZZZZZZZZZZZZZZZZZZZZZZZZZZZZZZZZZZZZZZZZZZZZZZZZZZZZZZZZZZZZZZZZZZZZZZZZZZZZZZZZZZZZZZZZZZZZZZZZZZZZZZZZZZZZZZZZZZZZZZZZZZZZZZZZZZZZZZZZZZZZZZZZZZZZZZ