ZZZZZZZZZZZZZZZZZZZZZZZZZZZZZZZZZZZZZZZZZZZZZZZZZZZZZZZZZZZZZZZZZZZZZZZZZZZZZZZZZZZZZZZZZZZZZZZZZZZZZZZZZZZZZZZZZZZZZZZZZZZZZZZZZZZZZZZZZZZZZZZZZZZZZZZZZZZZZZZZZZZZZZZZZZZZZZZZZZZZZZZZZZZZZZZZZZZZZZZZZZZZZZZZZZZZZZZZZZZZZZZZZZZZZZZZZZZZZZZZ
                                                                                                                  Z                                                                                                                             
               CCCCCCCCCC                       CCCCCCC                                                           Z                      CCCC                                                       CCCCC                                CC     
               CCCCCCCCCC                       CCCCCC                                                            Z                       CC                       C                            CCCCC          C                         CC     
                                                CC                     Z                             Z     C      Z                                               C C                        CCCCC            C                                 
   ZZZZZZZZZZZZZZZZZZZZZZZZZZZ                                         Z                            Z Z     C     Z              ZZZZZZZZZZZZZZZZZZZZ            C   C         CCC              CCC       ZZZZZZ     ZZZZZZZZZZZZZZZZZZZZZZZZZZZ
   ZZZZZZZZZZZZZZZZZZZZZZZZZZZ                                         Z                           Z   Z     C                                                  C     C        CCC            Z   CC                 ZZZZZZZZZZZZZZZZZZZZZZZZZZZ
                                    CC                 Z                      CCCCCCCCCCC         Z     Z     C                  CCCCCCCCCCCCCCCCCCCC          C   Z   C       CCC             Z    C     CCCCCC                                
                       CC         CCCCCC               Z                                         Z       Z     C                                              C   Z Z   C                       Z          CCCC                  CCCCCCCCCC     
                       CC       CCCCCCCCCC             Z                      ZZZZZZZZZZZ       Z         Z     CCCCCC           ZZZZZZZZZZZZZZZZZZZZ        C   Z   Z   C                       Z          CC                   CCCCCCCCCC     
                                                       Z                                       Z           Z                                                C   Z     Z   C                                                                     
ZZZZZZZZZZZZZZZZZZZZZZZZZZZZZZZZZZZZZZZZZZZZZZZZZZZZZZZZZZZZZZZZZZZZZZZZZZZZZZZZZZZZZZZZZZZZZZZZZZZZZZZZZZZZZZZZZZZZZZZZZZZZZZZZZZZZZZZZZZZZZZZZZZZZZZZZZZZZZZZZZZZZZZZZZZZZZZZZZZZZZZZZZZZZZZZZZZZZZZZZZZZZZZZZZZZZZZZZZZZZZZZZZZZZZZZZZZZZZZZZ